11 7 7 7 7 7 7 7 7 7 7 7 7 7 7 12
5 0 0 0 0 0 0 0 0 0 0 0 0 0 13 6
5 0 0 0 0 0 0 0 0 0 0 0 0 0 0 6
5 0 0 0 0 0 0 0 0 0 0 0 0 0 0 6
5 0 0 0 0 0 0 0 0 0 0 0 0 0 0 6
5 0 0 0 0 0 0 0 0 0 0 0 0 0 0 6
5 0 0 0 0 0 0 0 0 0 0 0 0 0 0 6
5 0 0 0 0 0 0 0 0 0 0 0 0 0 0 6
5 0 0 0 0 0 0 0 0 0 0 0 0 0 0 6
5 0 0 0 0 0 0 0 0 0 0 0 0 0 0 6
5 0 0 0 0 0 0 0 0 0 0 0 0 0 0 6
9 8 8 8 8 8 8 8 8 8 8 8 8 8 8 10

